1111111111111
100000C10C0C1
101C101C10101
1010101C10101
1P0C000C0C0E1
1111111111101
1111111111111
